Hd,Hd,Hd,Hd,Hd,Hd,Hd,Hd,Hd,Hd,Hd,Hd,Gd,Gd,Gd,Gd,Gd,Gd,Gd,Gd,Gd,Gd,Gd,Gd,Gd,Gd,
Hd,Md,Md,Md,Md,Hd,Ch,Kh,Ch,Hd,Hd,Gd,Gd,Gd^Fdf,Gd,Gd,Gd,Gd^Vh,Gd,Gd,Gd,Gd,Gd,Gd,Gd,Gd,
Hd,Md,Md,Md,Hd,Gd,Hd,Ch,Ch,Gd,Gd,Gd,Gd,Gd,Gd,Gd,Gd,Gd,Gd,Gd,Gd,Gd^Fmw,Gd,Gs^Fmw,Gd,Gd,
Hd,Hd,Hd,Hd,Hd,Gd^Vh,Gd,Gd,Gd,Gd,Gd,Gd^Fdf,Gd,Gd^Vh,Gd,Gd,Gd,Hhd,Hhd,Gd,Gd,Gd,Gd^Fmw,Gs^Vh,Gd,Gd,
Hd,Hd,Hd,Hd,Hd,Gd,Gd^Fdf,Gd,Gd,Gd,Gd,Gd,Gd,Gd,Gd,Gd,Gd,Hhd,Hhd,Hhd,Gd,Gd,Gd^Fmw,Gs,Gd,Gd,
Hd,Gd,Gd,Gd,Hd,Gd,Gd,Gd,Gd,Gd,Hhd,Hhd,Gd,Gd,Gd,Hhd,Hhd,Mm,Mm,Hhd,Gd,Gd,Gs,Gs^Fmw,Gd,Gd,
Gd,Gd^Vh,Gd,Gd,Gd,Gd,Gd,Gd,Gd,Gd,Hhd,Mm,Hhd,Hhd,Hhd^Fdf,Hhd,Mm,Mm,Hhd,Hh,Gs,Gs,Gs^Fmw,Gs^Fmw,Gd,Gd,
Gd,Gd,Gd,Gd,Gd^Fdf,Gd,Gd,Gd,Gd^Vh,Gd,Hhd,Hhd,Mm,Mm,Hhd,Mm,Mm,Hhd,Hhd,Gd,Gd^Vh,Gs^Fp,Gs,Gs^Fmw,Gd,Gd,
Gd,Gd,Gd,Gd,Gd,Gd,Gd,Gd,Gd,Gd,Hhd,Hhd,Mm,Ch,Kh,Ch,Mm,Hhd,Hhd,Hhd,Hh,Gd,Gs^Fmw,Gs^Fmw,Gd,Gd,
Gd,Gd,Gd,Gd^Vh,Gd,Gd,Gd,Hhd,Gd,Hhd,Hhd,Hhd,Mm,Ch,Ch,Mm,Mm,Mm,Mm,Hhd,Hhd,Gd,Gs^Fmw,Gs^Fmw,Gd,Gd,
Gd,Gd,Gd,Gd,Gd,Gd,Hhd,Hhd,Hhd^Fdf,Hhd,Mm,Mm,Mm,Mm,Mm,Mm,Mm,Mm,Mm,Hhd,Gd^Fmw,Gs^Fmw,Gs,Gs^Fmw,Gd,Gd,
Gd,Gd,Gd^Fmf,Gd,Gd^Fmf,Gd,Gd,Hhd,Hhd,Hhd^Fmf,Hhd,Hhd,Hhd,Hhd,Mm,Mm,Mm,Mm,Hhd,Hhd,Hh,Gs^Fmw,Gs,Gs^Fmw,Gd,Gd,
Gd,Gd,Gd^Fmf,Gd^Fmf,Gd^Fmf,Gd^Fmf,Gd,Hhd,Hhd^Fmf,Gd^Fmf,Hhd^Fmf,Ch,Hhd,Hhd,Hhd,Mm,Mm,Mm,Mm,Hhd,Hhd^Fmw,Hh,Gs,Gs^Fmw,Gd,Gd,
Gd,Gd,Gd^Fmf,Gd^Fmw,Gd^Fmf,Hhd^Fmw,Hhd^Fmf,Gd,Gd,Gd,Gd^Fmf,Ch,Kh,Ch,Hhd,Hhd,Hhd,Hhd,Hhd,Hhd^Fmw,Hh^Fmw,Gs^Vh,Gs^Fmw,Gs,Gd,Gd,
Gd,Gd,Gd,Gll^Fmf,Gd^Fmw,Gd^Fmf,Gd^Fmf,Gd^Fmw,Gd^Vh,Gll^Fmf,Gd^Fmf,Ch,Gd^Fmf,Gd^Fmw,Gd^Fmw,Gd^Fmw,Hhd,Hhd,Gd,Gd,Hh^Fmf,Gs,Gs^Fmw,Gs^Fmw,Gd,Gd,
Gd,Gd,Gd,Gll^Fmf,Gd,Gd,Gd^Fmf,Gll^Fmf,Gll^Fmw,Gll^Fmw,Gll^Fmf,Gll^Fmf,Gll^Fmf,Gll^Fmf,Gd^Fmf,Gd^Fmw,Gd,Gd,Gd^Fmf,Gd^Fmf,Gd^Fmf,Gd,Gs^Fp,Gs^Fmw,Gd,Gd,
Gd,Gd,Gd,Gll^Fmf,Gd^Fmw,Gd^Fmf,Gd^Fmf,Gd^Fmw,Gd^Vh,Gll^Fmf,Gd^Fmf,Ch,Gd^Fmf,Gd^Fmw,Gd^Fmw,Gd^Fmw,Hhd,Hhd,Gd,Gd,Hh^Fmf,Gs,Gs^Fmw,Gs^Fmw,Gd,Gd