Gg,Gg,Gg,Gg,Gg,Gg,Gg,Gg,Gg,Gg,Gg,
Gg,Gg^Vh,Gg,Gg,Gg,Gg,Gg,Gg,Gg,Gg^Vh,Gg,
Gg,Gg,Gg,Gg,Gg,Gg,Gg,Gg,Gg,Gg,Gg,
Gg,Gg,Gg,Gg,Ch,Ch,Gg,Gg,Gg,Gg,Gg,
Gg,Gg,Xv,Mm,Hh,Gg^Vh,Gg,Gg,Gg,Gg,Gg,
Gg,Gg,Xv,Gg,Gg^Fp,Gg^Vh,Gg^Fp,Mm,Xv,Gg,Gg,
Gg,Gg,Gg,Gg,Gg,Ch,Hh,Gg,Xv,Gg,Gg,
Gg,Gg,Gg,Gg,Gg,Gg,Ch,Gg,Gg,Gg,Gg,
Gg,Gg^Vh,Gg,Gg,Gg,Gg,Gg,Gg,Gg,Gg^Vh,Gg,
Gg,Gg,Gg,Gg,Gg,Gg,Gg,Gg,Gg,Gg,Gg